Format	Risk
Open Reel Video	Extremely High
U-Matic	Very High
Betamax	Very High
VHS & S-VHS	High
Betacam & Betacam SP	High
Video 8 & Hi8	Very High
D2	Very High
D3	Very High
DVCAM	High
MiniDV	High
DVCPro	Very High
Digital 8	Very High
Open Reel Audio	Moderate
Compact Cassette	Moderate
Microcassette	High
DAT	Very High
DTRS	Very High
F-1	Very High
DCC	Very High
8-Track	High
